30 30
##############-###############
#               +            #
# ########################## #
# #          #  M          # #
# # ### ########## ####### # #
# # #    #    M        A # # #
# # # ############## ### # # #
# # # #                # # # #
# A # # ############## # # # #
# # # ###     #      # # #   #
# # # # # ###### ### #A# # # #
# # # # # # #M     # ### # # #
# ### #   # ###### # # # # # #
# # # # # #   #O # # # # ### #
# # #   ### # ## # # #M# # # #
# # # # #   # #A # #   #   # #
# # # ### ### #  # # # # # # #
# # # # # # ### ## #A# # # # #
# # # # # #        # # ### # #
#   # # # ########## # # # # #
# # # # #            # # # ###
# # ### ############## #M# # #
# # # #                #   # #
# # # #### ############# # # #
# # #                    # # #
### ########### ########## # #
# #        #          #    # #
# ################# ######## #
#                            #
##############################
