30 30
##############################
# ##   ##     -            # #
# ## # ## # ##### ### #### # #
#    # ## # #   # # # ###  # #
###### #  # ####  # #   # #  #
#      ## # ####  #   ###    #
# ## #### # #   # ### #### ###
# #       # ##### #   #  # # #
# #########       ### # ## # #
# #       # ##### #   # #  # #
# # # # ###   #   # ### # ## #
#   #     #   #   # ###   #  #
####### ###   #   # ####### ##
#         # ##### # #####   ##
# ### ### #       #     # ####
# #     # # ##### #### ## ## #
# # ##### # #     #     #  # #
# # #     # #     # ## ### # #
# # ##### # #     # #  ##  # #
# #       # ##### # ## #  ## #
# ####### #       #    # # # #
#     #   #   #   ###### # # #
##### ## ##  # #  #      #   #
#   # #   # #   # ### ########
# # # # # # ##### #      #   #
# #   #   # # + # ##### ## # #
# ####### # #   # #     #  # #
# #   # # #       # ###### # #
#   #     # ##### #        # #
##############################