30 30
##############################
#     #     #        #       #
# ###   ### # #####  ### ### #
# #-# # #   ##    ##     # # #
# # # # # # # # ###  ##### # #
# # # # #            #       #
# # #   # ### ### # ## # # # #
# # ## ## # #     # #  ##  # #
# #       # ### ### ## #  ## #
# #########       #    # # # #
#      #  # #### ####### # # #
#  ### #    #  #   #     # ###
#### # # ##### ##### ### # # #
#      #   #       # # #   # #
# #### # ##### ### # # ##### #
#  #     # # # # # # # #     #
##   #####     # # # # # # ###
# ## #   ####### # # # # # # #
# #  # ##        #     #   # #
# # ## ## # ##### ### #### # #
#    # ## # #   # # # ###  # #
###### #  # ####  # #   # #  #
#+### # #       # # # ##### ##
#        ### # #  # #        #
#### # #     # # #  # ###### #
#  # #   # ### # # #     #   #
#  # ##### # # # # ### #### ##
#  # #       #         #     #
#    # ## # ## # ##### # ### #
##############################