30 30
##############################
#      #   #       # # #   # #
# #### # ##### ### # # ##### #
#  #       # # # #   # #     #
##   #####     # # # # # # ###
# ## #   ####### ### # # # # #
# # ## #  #    # # #   #   # #
#       #  # #     # #   #   #
# # # #  # # ##### #   ##### #
# # #  #  #  #   #  # #    # #
# #  #  ##  #  #  #  #  #  # #
#  #  #    #  #-#  #   #  #  #
#   #  #  #  #   #  # #  #   #
# #  #  ##  #  #  #  #  #  # #
#     #    #  #+#  #   # # # #
### ## #  #  #   #  # ## # # #
# # #   ##  ### ###  #   # # #
# # # #  #  #     # ## # ### #
# #   #  #  # ### #  # # #   #
#   ###  #  # #   # ## # # # #
# ###       # #####    # #  ##
#   # ##### #     ###### ##  #
#  #      # ## #####     # # #
## # ###### #  # # # ##### # #
#           ## #         # # #
#  ########  # ####### ### ###
# #         ##       # #     #
# # ### ###  ##### ##### # # #
# #        #     #       # # #
##############################