30 30
##############################
#             -              #
# ########################## #
# #          #             # #
# # ### ########## ####### # #
# # #    #               # # #
# # # ############## ### # # #
# # # #                # # # #
#   # # ############## # # # #
# # # ###     #      # # #   #
# # # # # ###### ### # # # # #
# # # # # # #      # ### # # #
# ### #   # ###### # # # # # #
# # # # # #   #+ # # # # ### #
# # #   ### # ## # # # # # # #
# # # # #   #  # # #   #   # #
# # # ### ### #  # # # # # # #
# # # # # # ### ## # # # # # #
# # # # # #        # # ### # #
#   # # # ########## # # # # #
# # # # #            # # # ###
# # ### ############## # # # #
# # # #                #   # #
# # # #### ############# # # #
# # #                    # # #
### ########### ########## # #
# #        #          #    # #
# ################# ######## #
#                            #
##############################