30 30
##############################
# #   #        -#     #   #   
# # # # # ####### ### # #   ##
# ### # #       # # # ##### ##
#        ### # #  # #        #
#### # #     # # #  # ###### #
#  # #   ##### # # #     #   #
#  # ##### # # # # ### #### ##
#  #       # # # # # #   #   #
#  #### #### # # # #   # # # #
#            #   # ##### # # #
# ### #### #######       # # #
# #    ### #     # ####### # #
#   ##       ###   #     # # #
######## ##### ##### ### # # #
#      #           # # #   # #
#  # # # ##### ### # # ##### #
#  #     # # # # # # # #     #
#    #####     # # # # # # ###
# ####   #######     # # # # #
# # #   # #      ##### # # # #
# # # # #   ########     # # #
# # # # # # # #      ##### # #
# #   #   # # #  ########### #
######## ## # #  #           #
#   #+##  # # #  # ######### #
# # # ## #    #  #         # #
# # # #### # ##  ########### #
# #        #  #              #
##############################